....................
....................
...wwwwwwwwwwwwww...
...w......c.....w...
...w.SIY......f.w...
...wc......c....w..C
...w........c.c.w..I
...w...s..c..c.cw..T
...wc.....c.F.N.w...
...w.c....c..c..w...
...w....c..c....w...
...wwwwwwwwwwwwww...
....................
....................
